4 1 0 0 2 4
2 4 2 4 1 0
0 0 2 0 4 2
1 1 0 0 4 2
2 4 1 4 0 1
3 0 4 1 0 4