3 4 2 2 0 2
1 1 1 1 1 1
0 1 3 0 3 1
1 3 1 3 1 1
1 1 1 1 1 1
3 0 0 4 0 1