3 2 1 1 2 1
1 2 1 0 2 2
2 1 1 1 2 1
1 2 1 1 2 1
0 2 1 1 2 4
3 0 0 4 0 4