2 0 2 3 0 2
0 2 1 3 2 1
2 0 1 3 0 2
0 2 3 3 2 1
2 0 1 3 0 2
0 2 0 3 2 1