1 3 0 1 1 2
0 4 0 0 2 3
3 1 0 0 3 1
1 2 0 0 1 2
4 3 1 0 4 3
2 4 1 1 2 4